3 10 10
65 43 39 
11 9 6 5 15 12 16 17 10 13 10 18 19 14 15 17 11 9 29 16 8 17 9 8 15 12 8 13 7 20 
17 14 15 12 14 12 14 15 15 15 15 18 11 14 12 14 14 17 17 15 16 15 13 14 15 15 15 13 15 14 15 16 16 15 15 14 15 15 14 17 14 14 15 14 15 16 13 15 16 12 16 14 15 16 14 14 13 15 15 14 14 14 15 15 17 15 14 13 15 13 16 14 12 14 13 16 16 15 15 16 17 14 15 14 15 15 15 14 15 14 16 15 14 13 16 13 12 16 14 16 14 17 11 14 17 15 16 14 16 13 14 14 14 17 16 15 13 15 15 15 14 13 14 16 15 16 13 14 13 13 13 15 15 14 13 14 15 14 15 16 13 14 15 14 13 13 15 16 15 14 14 16 16 16 12 15 15 13 14 16 13 15 14 14 12 18 16 13 16 14 16 15 14 15 14 15 15 14 13 15 14 16 15 14 15 13 15 15 16 14 13 15 17 14 15 14 16 13 15 14 15 15 17 13 14 16 15 14 16 13 14 11 13 16 14 14 13 17 15 15 15 14 13 13 14 16 14 15 17 14 14 15 13 14 15 13 16 13 16 15 15 15 14 17 16 15 16 14 14 15 15 17 13 12 13 16 13 15 15 17 15 15 15 15 12 16 16 14 15 16 15 17 15 16 16 14 15 13 14 14 15 15 16 13 14 15 15 15 12 14 13 13 16 13 14 14 15 15 15 13 

1000 5 0 0
400 120 0 0
120 20 0 0

Companies:
10
Company0:
3 5 3 3 0 50
0 1 2 
0 3 1 2 2 3 0 2 1 0 
1 1 1 
1 1 0 

2 3 1 0 2 3 2 3 1 2 1 0 1 2 2 3 0 3 1 0 1 0 1 0 0 2 0 2 2 3 2 3 0 3 1 0 0 3 1 2 0 2 0 3 1 0 0 3 0 3 1 0 0 3 0 3 2 3 2 3 2 3 2 3 0 3 0 2 0 3 2 3 2 3 0 2 1 2 0 3 1 2 0 3 0 2 1 0 1 0 1 0 0 3 1 2 1 2 0 2 

Company1:
3 5 3 3 0 50
1 2 0 
1 4 1 3 2 4 0 0 2 2 
2 2 1 
1 1 2 

1 3 2 4 0 0 2 4 1 3 0 0 1 4 2 2 2 2 1 4 2 2 1 4 2 4 1 3 2 2 1 4 0 0 1 4 1 3 1 3 1 3 1 4 2 2 2 4 2 2 1 4 2 2 2 2 0 0 0 0 0 0 2 4 2 4 1 4 1 3 0 0 2 4 1 3 2 4 1 4 1 4 2 2 0 0 0 0 1 4 1 3 1 3 1 3 1 3 2 2 

Company2:
3 5 3 3 0 50
2 0 1 
0 1 0 4 2 4 2 3 2 1 
1 2 2 
0 0 1 

0 4 2 4 2 3 0 1 2 1 0 1 2 4 2 3 2 1 2 4 2 3 2 4 0 4 0 1 2 4 2 1 2 4 2 4 2 1 0 4 2 4 2 1 2 3 0 4 0 4 0 4 2 3 0 1 2 4 2 3 2 4 0 1 0 4 0 1 0 1 2 1 0 1 2 3 0 1 0 1 0 1 0 4 2 3 2 4 2 3 2 1 2 4 2 1 0 4 0 1 

Company3:
3 5 3 3 0 50
0 1 2 
2 2 1 0 0 1 1 2 1 1 
0 1 0 
0 1 1 

0 1 0 1 1 2 2 2 1 1 1 0 1 0 1 1 1 2 1 2 1 2 1 2 1 1 2 2 1 1 1 1 1 1 0 1 2 2 1 2 2 2 1 0 1 0 1 2 1 0 2 2 2 2 2 2 1 0 1 1 1 1 1 2 1 1 1 0 1 0 1 1 1 2 1 1 0 1 1 2 1 2 0 1 1 0 0 1 1 1 1 0 1 1 1 2 1 2 1 1 

Company4:
3 5 3 3 0 50
0 2 1 
2 0 0 3 2 1 0 2 1 4 
0 2 1 
0 0 0 

0 2 2 1 2 0 0 3 0 2 2 0 2 0 0 2 2 1 1 4 0 3 0 2 0 2 0 3 0 2 0 2 2 0 1 4 0 3 0 2 0 3 0 2 1 4 0 2 0 3 0 3 0 3 1 4 0 2 0 3 1 4 2 0 2 0 1 4 2 1 2 0 0 3 2 0 1 4 0 2 2 0 1 4 1 4 0 2 0 2 0 2 0 3 0 3 0 2 0 3 

Company5:
3 5 3 3 0 50
2 1 0 
0 1 0 2 2 1 1 1 0 0 
2 1 2 
1 1 1 

0 0 0 0 0 2 2 1 0 1 0 0 0 1 2 1 1 1 1 1 0 1 0 0 0 2 0 0 1 1 2 1 1 1 2 1 1 1 0 1 0 0 0 0 0 1 2 1 0 0 0 0 0 1 1 1 2 1 0 2 2 1 2 1 1 1 0 1 0 1 0 0 0 0 0 1 0 2 0 1 2 1 2 1 0 1 2 1 2 1 0 2 0 2 0 2 1 1 0 0 

Company6:
3 5 3 3 0 50
2 1 0 
1 3 2 1 2 4 0 0 2 0 
2 2 2 
2 1 1 

2 0 0 0 2 0 2 1 0 0 0 0 2 0 1 3 2 1 0 0 0 0 2 0 0 0 2 0 2 4 1 3 1 3 1 3 0 0 2 0 2 1 0 0 2 1 2 0 2 0 0 0 0 0 2 1 1 3 2 0 2 1 2 0 2 4 0 0 0 0 2 0 2 0 2 0 1 3 1 3 1 3 0 0 0 0 2 0 0 0 0 0 0 0 2 4 0 0 0 0 

Company7:
3 5 3 3 0 50
0 1 2 
1 1 0 4 1 4 0 0 0 2 
1 2 2 
1 0 0 

0 4 0 2 1 4 1 1 1 4 1 1 0 2 0 4 0 2 1 1 1 1 0 4 1 1 1 4 0 4 0 4 0 2 1 1 0 0 0 0 0 0 0 4 1 1 0 2 0 2 1 1 1 1 0 0 0 0 0 0 0 4 0 2 0 0 0 2 0 0 1 4 1 4 1 1 0 2 1 4 0 2 0 0 1 1 1 4 0 4 1 4 1 4 0 4 0 4 1 1 

Company8:
3 5 3 3 0 50
0 1 2 
1 4 0 0 2 1 0 4 1 0 
0 1 0 
0 1 2 

1 0 1 4 0 0 1 4 1 0 1 0 1 0 0 4 0 0 1 0 1 0 1 4 1 0 0 4 1 4 1 4 0 4 0 4 1 4 1 0 2 1 0 4 0 0 0 0 1 0 1 0 1 4 0 0 0 4 1 0 0 0 0 4 2 1 1 4 0 4 2 1 2 1 1 0 0 0 2 1 1 0 2 1 1 4 1 0 0 0 0 0 1 4 0 4 0 0 0 4 

Company9:
3 5 3 3 0 50
2 1 0 
0 1 1 0 2 3 1 2 0 0 
2 0 1 
1 1 0 

1 0 1 2 0 1 1 0 2 3 1 2 0 1 1 2 1 0 1 2 1 0 1 0 1 2 2 3 0 1 0 1 0 0 0 0 1 0 0 1 2 3 1 2 0 0 0 1 2 3 1 0 1 2 0 1 0 0 1 2 1 2 1 0 0 1 0 1 2 3 0 0 1 0 2 3 1 0 1 2 2 3 0 1 1 0 0 1 0 0 1 2 0 0 1 2 1 2 2 3 


Producers:
20
Producer0:
2 27 9 1.0 14 9 1.0 0 8 7
Producer1:
2 14 7 1.0 10 10 1.0 0 4 4
Producer2:
2 17 10 1.0 22 8 1.0 2 6 8
Producer3:
2 18 8 1.0 23 11 1.0 1 9 3
Producer4:
2 19 10 1.0 22 9 1.0 1 3 2
Producer5:
2 14 13 1.0 21 8 1.0 1 2 2
Producer6:
2 22 8 1.0 13 10 1.0 0 9 6
Producer7:
2 17 8 1.0 18 8 1.0 2 0 9
Producer8:
2 25 12 1.0 15 10 1.0 2 9 8
Producer9:
2 8 9 1.0 10 9 1.0 2 7 2
Producer10:
2 20 10 1.0 21 10 1.0 1 4 0
Producer11:
2 32 6 1.0 16 7 1.0 1 3 5
Producer12:
2 17 9 1.0 29 12 1.0 0 0 5
Producer13:
2 22 11 1.0 23 8 1.0 2 5 0
Producer14:
2 16 11 1.0 22 10 1.0 1 7 7
Producer15:
2 14 10 1.0 18 10 1.0 0 0 8
Producer16:
2 24 11 1.0 20 10 1.0 1 7 2
Producer17:
2 16 10 1.0 20 9 1.0 0 6 5
Producer18:
2 31 9 1.0 15 10 1.0 0 5 8
Producer19:
2 18 10 1.0 24 8 1.0 1 4 4
