3 5 10
38 40 41 
21 16 17 20 7 9 11 17 17 9 20 16 14 23 13 
15 14 15 15 15 13 14 14 13 14 15 15 16 14 14 17 16 14 14 14 15 14 14 15 16 15 13 14 11 14 15 15 13 16 15 15 15 16 15 12 16 13 13 16 15 14 14 16 16 12 15 16 16 15 14 13 15 14 15 15 13 14 14 16 14 14 15 13 16 17 15 12 14 15 13 14 15 14 16 14 14 12 15 13 15 13 13 15 15 15 16 15 16 14 14 14 13 17 15 12 16 15 14 14 15 17 15 14 16 15 15 15 13 14 15 14 15 14 15 15 15 14 13 18 14 12 14 15 14 16 16 13 15 14 13 14 16 14 14 14 16 16 15 13 15 15 14 16 12 13  0 0 0 0
0 0 0 0
0 0 0 0 10 3 5 3 0 5 50
0 1 2 
1 1 0 2 0 3 1 3 2 2 
2 0 2 

0 2 1 3 1 3 0 2 0 2 
2 2 1 3 0 3 0 3 2 2 1 1 0 2 0 2 0 3 0 2 0 3 0 3 1 3 1 1 0 3 0 2 2 2 0 3 1 1 1 3 0 2 0 3 2 2 0 3 0 2 0 2 2 2 0 2 1 1 2 2 0 3 2 2 1 1 0 2 0 3 1 1 0 2 1 3 2 2 0 3 0 3 0 3 2 2 0 3 0 2 1 1 0 3 1 3 0 2 1 1  3 5 3 0 5 50
2 1 0 
1 3 0 0 1 0 0 4 0 2 
0 2 0 

0 2 0 0 0 0 1 0 0 0 
0 4 0 0 1 0 0 2 1 0 1 3 0 4 1 3 1 0 0 4 0 0 1 3 0 0 0 4 0 2 1 3 0 4 1 0 0 2 1 0 0 0 0 2 1 0 0 0 0 4 1 3 1 0 0 0 0 2 0 4 1 3 0 2 1 3 0 2 0 0 0 4 0 2 0 2 0 4 1 3 1 0 0 4 1 3 0 4 0 0 0 4 0 2 0 0 0 4 0 0  3 5 3 0 5 50
0 2 1 
0 2 1 3 2 0 2 4 2 3 
0 0 1 

2 4 0 2 1 3 2 3 1 3 
0 2 2 0 2 4 1 3 1 3 2 0 0 2 0 2 2 3 1 3 2 3 1 3 2 4 2 0 1 3 2 0 2 4 1 3 2 3 2 0 2 3 2 3 1 3 0 2 2 4 0 2 0 2 0 2 0 2 2 0 2 4 2 3 2 4 2 3 1 3 2 3 0 2 1 3 0 2 0 2 0 2 1 3 1 3 2 0 2 3 1 3 1 3 2 3 1 3 0 2  3 5 3 0 5 50
2 1 0 
0 3 0 0 1 1 2 0 2 2 
2 1 2 

1 1 0 3 0 3 0 0 1 1 
0 0 0 3 0 0 2 2 2 0 1 1 0 3 2 2 1 1 0 3 0 0 0 3 2 0 2 2 0 0 0 0 0 3 2 0 2 2 0 0 2 0 2 0 1 1 0 3 2 2 0 0 2 2 1 1 1 1 2 0 2 0 2 0 2 0 2 0 0 3 2 0 1 1 0 0 2 0 2 0 2 2 0 0 2 2 1 1 2 2 0 0 1 1 2 0 1 1 2 0  3 5 3 0 5 50
2 1 0 
0 1 2 4 1 0 1 2 2 1 
1 1 1 

1 2 1 0 1 0 0 1 0 1 
1 2 2 4 1 0 0 1 2 4 2 1 1 2 2 4 2 1 2 1 1 0 2 4 2 4 0 1 2 4 1 2 2 1 2 1 2 4 1 0 1 2 1 2 2 1 2 1 1 2 1 2 0 1 2 4 1 0 2 4 1 0 1 2 0 1 1 2 1 2 1 2 2 4 1 0 0 1 1 2 2 4 2 4 1 0 2 1 1 2 1 0 2 1 1 2 1 2 2 4  3 5 3 0 5 50
1 2 0 
1 2 0 4 2 1 1 0 1 1 
0 2 1 

1 2 0 4 0 4 1 1 0 4 
1 1 2 1 1 0 1 2 1 2 2 1 1 1 0 4 2 1 1 0 2 1 2 1 2 1 1 1 0 4 1 0 1 0 1 2 1 0 1 1 2 1 2 1 0 4 1 2 1 2 1 1 2 1 1 0 1 2 1 0 1 1 1 2 2 1 1 0 1 0 2 1 0 4 1 0 0 4 0 4 0 4 2 1 1 2 2 1 1 1 2 1 1 1 1 2 1 1 0 4  3 5 3 0 5 50
0 2 1 
1 2 2 1 0 2 2 0 0 4 
0 1 0 

2 1 0 2 1 2 1 2 2 0 
1 2 1 2 1 2 2 0 2 1 0 4 1 2 2 1 1 2 0 2 0 2 0 4 2 0 0 2 1 2 2 0 1 2 2 0 0 4 2 1 0 2 1 2 0 2 0 4 2 1 1 2 2 1 2 1 2 0 0 4 2 0 2 1 0 4 2 0 0 2 2 1 0 2 2 1 0 4 2 0 0 4 1 2 0 4 0 4 2 0 1 2 0 4 2 0 2 1 2 1  3 5 3 0 5 50
0 1 2 
1 4 1 0 2 2 0 2 0 3 
2 2 1 

1 0 2 2 1 0 1 4 0 2 
1 0 1 0 1 0 1 0 0 2 0 3 0 3 1 4 1 0 1 0 1 4 1 0 1 0 2 2 0 2 1 4 2 2 2 2 2 2 1 4 1 4 0 3 1 0 1 0 0 2 1 0 1 0 0 3 1 4 0 2 0 2 0 2 0 2 1 0 2 2 0 3 0 3 1 4 0 2 1 0 0 2 1 4 0 2 0 2 0 2 1 4 0 2 0 3 0 3 0 2  3 5 3 0 5 50
1 2 0 
0 4 1 3 0 0 1 0 2 0 
1 1 0 

1 0 0 4 1 3 0 0 0 0 
1 0 1 3 0 4 0 0 1 3 2 0 0 4 1 0 2 0 1 3 1 0 2 0 0 4 2 0 1 3 1 3 0 4 0 4 1 3 2 0 1 0 1 0 0 4 0 0 0 4 1 3 2 0 2 0 2 0 0 4 0 0 2 0 1 0 1 3 1 0 1 3 1 3 1 3 2 0 1 3 1 3 0 4 0 0 1 3 1 3 2 0 0 0 1 0 0 0 1 0  3 5 3 0 5 50
2 0 1 
2 0 2 4 1 0 0 1 0 4 
0 0 1 

2 0 0 4 2 0 2 4 0 4 
2 4 0 1 0 1 2 4 2 4 2 0 2 0 2 4 2 4 2 0 1 0 2 4 1 0 1 0 0 1 0 4 0 4 1 0 0 4 1 0 0 1 1 0 0 1 0 4 0 1 1 0 0 4 0 4 0 4 2 4 2 4 0 4 0 1 2 4 0 1 2 4 2 4 0 1 1 0 1 0 0 1 0 1 0 1 0 1 1 0 2 0 2 4 1 0 0 4 2 4  20 2 25 11 1.0 22 10 1.0 1 0 6 2 12 9 1.0 26 9 1.0 2 0 4 2 18 10 1.0 23 10 1.0 0 3 1 2 21 7 1.0 22 10 1.0 1 2 9 2 19 10 1.0 16 10 1.0 1 0 4 2 13 10 1.0 18 10 1.0 2 3 3 2 22 9 1.0 17 12 1.0 0 2 4 2 20 12 1.0 21 11 1.0 1 3 7 2 15 12 1.0 23 11 1.0 0 0 5 2 14 11 1.0 25 7 1.0 1 4 6 2 25 7 1.0 18 10 1.0 0 2 9 2 26 10 1.0 16 10 1.0 0 1 7 2 21 10 1.0 16 10 1.0 0 2 8 2 25 9 1.0 28 10 1.0 2 2 1 2 19 9 1.0 19 10 1.0 2 3 1 2 17 10 1.0 18 9 1.0 0 0 4 2 16 9 1.0 24 8 1.0 1 0 5 2 14 11 1.0 15 10 1.0 0 1 3 2 24 9 1.0 15 7 1.0 0 3 8 2 23 10 1.0 16 11 1.0 1 0 6 